53 129
0 0
52 128
13 12 8 10 10 10 8 11 12 10 10 10 8 10 10 10 9 12 10 10 10 9 12 10 8 10 8 10 10 10 10 10 9 12 9 12 9 14 10 10 10 10 10 10 8 10 9 12 8 10 8 10 8 10 9 14 10 10 9 12 9 12 10 9 12 11 12 9 14 8 10 11 12 10 10 9 14 8 11 12 10 10 8 10 10 10 10 10 10 10 10 10 10 10 10 9 12 9 12 10 10 9 12 10 8 9 12 10 10 8 10 10 10 10 11 12 10 10 10 10 10 10 10 10 10 9 12 10 9 
5 5 5 12 10 9 6 10 1 12 10 10 3 12 9 12 1 6 9 13 12 3 5 13 4 9 5 12 10 10 9 13 5 5 7 5 6 10 10 10 10 10 10 9 6 11 6 3 6 11 5 12 3 14 2 10 10 9 5 7 5 7 12 3 5 12 3 6 9 5 12 10 3 14 9 6 10 3 12 3 12 9 4 10 10 10 10 9 14 9 13 12 11 12 9 5 5 5 6 10 9 5 5 12 3 7 6 9 13 6 9 12 10 8 9 6 9 12 10 10 10 10 10 9 13 4 2 11 5 
5 5 5 6 11 5 12 9 5 4 10 10 9 5 6 3 6 9 6 3 6 9 6 3 7 5 5 5 14 9 5 4 3 5 12 3 12 10 9 14 8 10 10 2 10 10 10 10 10 8 3 6 10 9 12 10 10 3 6 9 6 9 4 10 2 3 14 9 5 5 5 14 10 8 1 12 10 10 3 12 3 5 6 10 8 10 11 6 9 5 5 6 9 5 5 5 5 6 10 9 5 6 3 4 10 10 10 3 6 9 4 2 9 7 6 9 5 5 12 10 10 10 11 4 3 6 11 12 3 
5 5 4 9 12 3 5 6 3 6 10 9 5 6 10 9 13 6 10 10 10 2 10 9 12 3 5 6 10 1 5 6 10 1 7 12 3 12 3 12 3 12 10 9 12 10 10 10 9 5 12 11 12 3 6 10 10 10 9 5 12 1 5 14 10 10 8 1 5 5 6 10 10 3 5 5 12 9 12 2 11 6 8 9 6 10 8 9 5 5 5 12 3 5 5 5 6 11 12 3 5 12 9 6 10 10 10 10 10 1 6 9 6 10 9 5 5 5 5 12 10 10 9 6 9 12 8 3 13 
6 3 5 5 6 9 5 12 10 10 10 1 5 12 9 5 6 10 8 10 10 10 9 6 3 14 2 8 10 3 5 12 10 3 12 3 14 2 10 3 12 2 9 6 3 12 9 12 1 5 5 12 3 12 9 12 9 12 3 6 3 5 5 12 10 9 5 5 6 3 12 10 9 12 3 5 5 6 3 13 12 9 7 6 9 13 5 5 6 3 5 6 10 3 5 6 9 12 3 13 5 5 6 10 10 10 9 14 9 6 9 5 12 9 5 6 2 3 6 3 12 9 5 13 5 5 6 10 3 
13 12 3 5 14 2 3 5 13 12 10 3 4 3 7 5 12 10 3 14 8 9 6 9 12 10 9 6 11 12 3 5 12 8 3 14 10 8 10 9 7 12 3 14 9 5 7 5 5 7 5 6 10 3 5 5 5 5 12 10 9 5 5 5 13 6 3 4 10 10 3 13 6 3 12 3 5 13 12 3 5 5 12 9 5 5 5 6 11 12 2 10 10 10 1 12 3 6 10 1 5 5 12 10 10 10 2 9 5 13 5 4 1 5 7 12 10 10 9 12 3 5 5 5 5 6 10 8 9 
5 4 9 4 9 14 10 1 6 3 12 10 3 12 8 3 4 10 10 9 5 6 10 3 5 12 3 12 9 5 12 3 5 5 14 9 12 2 9 6 10 3 12 9 4 3 12 3 6 8 2 10 10 9 5 5 5 6 3 12 3 6 1 5 5 13 12 3 12 10 10 1 12 10 3 12 3 4 1 12 3 5 5 6 3 5 6 10 9 7 12 10 10 10 3 7 12 10 10 3 5 5 5 12 11 12 9 6 3 6 3 5 7 5 12 3 14 9 5 6 9 6 2 3 5 12 9 7 5 
5 5 5 5 6 10 9 4 10 9 7 12 10 3 5 13 6 10 11 5 6 9 12 8 3 6 9 5 5 5 5 12 3 6 10 3 6 11 6 10 10 10 3 5 6 10 3 13 12 1 13 12 9 5 5 5 6 10 9 6 10 9 5 6 3 5 6 9 7 12 9 5 4 9 12 1 12 3 5 6 9 5 5 14 8 1 12 9 6 10 3 12 10 10 10 9 4 11 12 10 3 5 5 5 12 3 4 10 11 12 9 5 12 3 6 10 10 3 6 9 6 9 12 9 5 5 6 8 1 
5 7 5 5 12 11 5 6 11 4 9 5 12 9 5 6 10 8 8 3 14 1 7 5 12 11 6 3 6 3 5 7 12 9 12 10 8 10 8 9 14 10 10 3 12 8 10 1 7 5 4 3 6 3 7 6 10 9 5 13 12 3 6 10 9 6 9 6 9 5 5 5 5 5 5 5 6 11 6 9 5 5 6 9 5 6 1 6 10 10 11 6 9 12 9 6 3 12 3 14 10 3 6 1 6 9 6 10 9 7 5 5 6 8 9 14 9 12 9 6 9 5 7 5 5 6 9 7 5 
5 12 3 6 3 12 3 12 9 7 5 5 5 5 5 14 8 1 5 12 9 6 10 3 6 9 14 10 10 10 2 9 5 4 1 12 2 9 5 6 10 10 10 10 3 6 11 6 10 3 5 14 10 10 8 10 10 3 5 5 6 10 10 9 6 9 5 14 2 3 6 1 5 6 3 6 10 9 12 2 3 7 12 3 5 12 2 10 10 10 10 8 3 5 6 10 10 3 12 8 11 12 10 3 12 3 14 9 4 9 5 6 11 5 6 9 5 5 6 10 3 6 10 1 6 9 6 9 7 
5 6 9 14 8 3 12 3 6 9 5 5 5 5 5 12 3 7 5 5 6 10 10 8 10 3 12 9 13 12 10 2 3 5 5 5 12 3 5 12 10 10 9 12 10 10 8 10 10 9 6 10 10 10 3 12 10 9 6 1 13 12 9 6 9 5 5 12 9 12 9 5 5 12 10 9 13 5 6 9 12 10 3 12 3 5 12 9 12 10 9 7 12 3 14 9 12 10 3 6 10 2 11 12 3 13 12 3 5 5 5 12 10 3 12 3 4 3 12 10 10 9 12 2 11 6 9 6 9 
6 10 3 12 3 12 3 14 9 6 3 5 5 7 5 5 12 9 7 5 13 12 9 6 10 11 5 4 3 6 11 12 10 3 5 5 5 12 3 6 10 9 7 5 12 10 3 12 9 6 10 11 12 9 12 3 12 3 12 3 4 3 6 9 6 1 6 3 5 5 6 3 6 1 13 6 3 6 10 3 7 12 9 5 12 3 7 5 5 13 6 9 6 10 9 5 6 10 9 12 11 12 9 4 10 3 5 14 3 6 3 5 14 10 3 12 3 12 2 10 11 4 2 10 9 13 6 9 5 
12 10 9 5 13 5 12 10 3 12 8 3 5 12 3 5 5 6 9 5 5 5 5 12 8 10 3 5 12 10 10 3 12 10 3 5 5 4 10 9 12 3 12 1 6 10 8 3 6 9 12 10 3 6 3 12 3 12 2 10 2 10 11 4 9 5 12 10 1 6 10 10 9 5 4 10 9 12 10 10 9 5 6 3 5 12 10 3 6 2 9 4 9 12 3 6 9 12 2 3 12 3 6 3 12 10 3 12 9 12 8 3 12 10 10 3 12 3 12 10 9 6 10 9 6 3 12 3 5 
5 12 3 6 3 5 5 12 9 5 6 10 3 5 12 3 6 9 5 6 1 7 5 7 6 11 12 3 7 12 10 9 4 10 9 5 5 6 11 5 5 12 1 5 12 9 7 12 9 6 2 10 9 12 9 6 10 3 14 9 14 10 9 5 6 3 6 11 6 9 12 10 3 5 7 12 1 5 13 12 3 6 10 11 6 1 12 10 8 11 5 5 7 6 9 13 5 5 12 10 3 12 10 9 5 12 9 5 5 5 5 12 3 12 10 9 5 13 6 9 6 10 9 5 14 8 3 14 1 
5 7 12 10 8 3 6 1 7 4 9 13 12 1 6 10 10 3 6 9 6 9 5 12 8 9 6 10 9 5 13 5 6 11 5 5 6 9 12 3 5 5 5 5 5 5 12 3 6 10 9 12 3 5 6 10 10 10 9 6 10 9 5 6 10 10 9 12 9 5 5 12 11 6 10 3 5 6 1 6 10 9 12 10 9 5 5 13 5 12 3 6 10 9 6 2 1 5 5 14 10 3 12 1 5 5 7 5 5 5 4 2 10 3 13 6 2 3 12 3 14 8 3 6 9 5 12 10 3 
6 10 3 12 3 12 10 2 9 7 4 3 5 6 10 10 10 10 9 6 10 3 5 5 5 6 10 9 6 3 5 6 10 10 3 6 9 5 5 12 3 5 5 7 5 6 3 12 9 12 3 6 8 3 12 10 10 9 4 8 11 5 5 12 10 9 6 1 6 3 5 6 10 9 12 10 3 12 3 12 9 5 5 13 6 3 6 3 5 5 12 10 11 4 8 11 5 5 6 10 10 10 3 6 1 4 9 5 5 5 7 12 9 12 1 13 12 10 3 14 9 5 14 10 3 5 5 12 9 
12 8 10 3 12 3 12 9 6 9 6 9 4 10 10 9 14 9 4 10 10 9 5 7 4 10 9 6 10 9 4 10 10 10 10 9 5 5 5 5 12 3 6 9 5 12 10 3 6 3 12 9 6 9 5 12 9 5 5 6 10 2 3 5 13 6 9 6 11 12 3 12 10 1 5 12 10 3 13 5 6 3 6 1 12 10 11 12 2 3 5 12 9 7 6 10 2 3 12 10 9 12 10 10 2 3 5 5 7 6 9 5 6 3 5 6 3 12 10 9 5 5 12 10 10 3 4 3 5 
5 6 10 10 3 12 3 5 13 6 9 5 6 10 9 4 10 3 7 12 10 3 6 9 7 12 3 14 10 2 3 12 11 12 9 6 3 5 5 5 6 9 12 3 7 6 9 12 10 9 5 5 14 3 5 5 7 5 6 10 9 14 9 6 2 9 6 10 9 6 10 3 12 2 3 6 10 10 1 6 10 10 9 6 1 12 10 3 12 9 6 3 6 10 10 10 9 12 3 13 4 3 12 10 9 13 5 6 10 9 4 3 14 9 4 9 12 2 9 5 6 1 5 13 12 10 3 13 5 
4 10 10 10 10 3 13 5 6 9 5 6 9 12 3 6 11 12 8 3 12 10 9 6 9 4 10 10 10 10 9 6 10 3 5 12 8 3 6 3 13 5 4 9 12 10 2 3 13 6 3 6 10 9 5 5 12 2 10 9 6 9 6 10 9 5 12 9 5 12 10 9 5 14 9 12 10 9 5 12 10 9 6 10 2 2 11 12 3 5 12 10 10 9 12 10 3 5 12 3 6 10 3 14 3 5 5 12 10 3 6 8 10 3 5 6 3 12 3 6 9 6 3 5 6 10 10 3 5 
4 10 8 10 9 12 3 6 9 5 5 13 5 4 10 10 9 5 6 10 2 11 4 9 5 6 10 10 9 12 2 11 12 10 3 7 6 10 10 9 4 3 5 6 2 10 10 8 3 12 10 9 13 6 3 5 4 10 9 6 9 6 10 10 3 5 5 6 3 5 12 3 6 9 5 5 13 4 2 3 13 5 12 9 14 9 12 3 14 3 5 12 10 3 5 12 10 3 6 10 10 10 10 10 9 5 4 1 12 10 9 6 11 12 3 12 10 1 12 9 5 14 9 6 10 10 10 10 1 
6 9 6 9 5 6 10 9 5 6 3 5 5 7 12 10 3 5 12 10 10 9 5 6 2 11 12 10 3 6 9 12 3 12 8 10 10 9 12 3 7 12 3 12 8 10 11 6 9 6 11 5 6 10 9 4 2 9 5 13 6 10 10 10 10 3 6 9 12 3 6 10 10 2 3 5 5 5 14 10 1 6 3 6 9 5 6 10 10 10 3 5 12 9 5 5 12 10 10 8 10 11 12 9 5 5 5 7 5 12 3 12 8 3 12 3 12 3 5 6 3 12 2 9 12 10 11 12 1 
13 4 9 5 6 10 9 6 1 12 10 3 5 12 3 13 12 3 6 9 12 3 6 10 10 9 6 10 10 9 5 5 13 5 6 8 9 6 3 12 9 5 12 3 6 10 8 9 6 10 10 2 10 11 5 6 9 5 6 3 12 10 10 10 10 10 9 6 1 12 9 14 10 9 12 3 5 6 10 10 2 10 10 9 6 2 10 10 10 9 12 3 5 6 2 3 5 14 9 6 10 8 3 5 4 3 7 12 3 5 13 5 5 12 3 14 3 12 3 12 9 7 12 3 6 10 9 5 5 
5 5 5 5 14 9 4 9 6 3 12 8 3 6 10 3 5 12 10 3 6 10 10 10 9 6 10 10 9 5 5 6 1 6 9 7 6 9 12 1 6 3 5 12 11 12 3 6 8 10 10 9 12 10 2 11 5 6 10 10 3 12 9 12 10 9 4 9 6 3 6 10 10 3 5 12 2 11 12 9 12 9 12 3 14 9 13 12 9 6 2 9 6 9 12 9 6 10 1 14 9 6 9 6 3 12 10 3 12 3 6 3 5 5 12 10 9 5 12 3 6 10 3 12 10 9 5 5 5 
5 7 5 6 10 3 7 6 9 14 3 5 12 10 10 10 1 6 10 9 12 10 10 11 6 9 12 9 5 5 6 10 3 13 6 9 13 5 5 7 12 10 3 6 9 6 8 9 7 12 9 5 5 12 10 9 5 13 12 10 10 3 6 3 12 3 5 6 10 8 10 10 10 10 3 5 13 12 3 6 3 5 5 12 9 5 6 3 6 9 13 6 9 5 7 6 10 9 4 10 3 13 5 13 12 1 14 10 2 9 14 8 3 5 6 9 6 3 5 12 10 9 12 3 13 5 5 5 5 
6 9 6 10 9 12 10 10 3 12 10 3 5 13 12 9 6 9 12 3 6 10 9 12 10 3 5 7 5 5 12 8 10 2 9 6 3 5 5 12 2 10 11 12 3 12 3 6 10 3 5 6 3 6 9 6 3 6 3 12 10 8 10 11 4 11 6 10 11 5 12 10 9 12 10 3 5 5 12 8 11 5 6 3 6 2 11 12 10 3 5 12 3 6 10 10 9 5 5 12 9 5 6 3 5 5 12 9 12 3 12 3 12 1 12 3 13 12 3 6 9 5 5 12 3 6 3 5 5 
14 2 9 12 3 5 12 9 14 2 10 11 6 3 5 6 9 5 6 10 10 9 5 6 9 13 6 10 3 5 5 5 13 12 3 12 10 1 4 2 9 12 10 3 12 3 14 9 12 11 5 12 10 9 6 10 10 10 10 1 13 4 10 9 5 12 10 8 10 3 7 12 3 6 10 9 6 3 5 6 9 6 10 9 12 10 9 4 10 10 3 4 8 10 10 9 5 5 5 5 7 4 9 12 3 7 5 6 2 10 1 12 1 7 6 10 3 6 9 12 3 5 6 1 12 10 8 3 5 
12 9 6 3 12 1 5 6 10 8 10 8 10 9 4 9 6 3 14 9 12 3 5 12 3 6 8 10 10 3 5 5 4 3 14 3 12 1 6 9 6 2 11 12 1 12 10 3 6 9 5 5 12 3 14 9 12 10 9 6 3 6 9 5 5 5 12 3 12 10 9 6 10 9 12 2 10 10 3 13 6 9 12 3 6 9 6 2 10 9 14 3 7 12 9 6 3 5 6 1 12 3 6 3 14 9 5 14 8 10 3 5 6 8 9 13 12 9 5 5 13 5 12 3 6 9 5 12 1 
5 6 10 10 3 5 6 9 13 4 9 5 12 3 7 6 8 10 9 5 4 10 3 5 14 8 3 14 10 8 3 5 6 9 12 8 1 6 11 4 10 10 9 5 4 2 10 10 9 6 3 7 5 12 9 6 3 12 2 10 11 12 3 4 1 5 5 12 3 13 4 10 11 5 5 13 12 10 9 5 12 3 5 14 9 5 14 9 13 4 9 12 9 5 6 10 10 3 12 3 6 10 10 10 9 5 6 9 5 12 9 6 11 5 5 5 5 6 2 3 5 5 6 9 12 3 5 7 5 
5 14 8 10 9 6 11 5 5 5 5 5 5 12 10 9 6 9 5 5 5 12 11 6 9 4 10 10 9 6 11 5 13 4 3 7 6 9 12 3 14 10 3 5 6 8 10 9 6 10 10 9 5 5 6 10 9 5 12 9 12 3 14 3 5 5 5 6 10 1 6 10 9 4 3 6 3 12 2 3 6 10 2 9 5 6 9 5 5 7 4 3 6 2 10 10 10 9 5 12 9 13 12 11 6 1 12 3 5 5 6 8 9 5 6 3 5 14 10 10 1 5 12 3 6 11 5 12 3 
6 9 5 12 2 10 9 6 3 5 5 5 6 3 12 3 12 3 5 5 7 6 9 13 5 7 12 10 3 12 8 3 6 3 12 9 13 5 4 10 9 12 10 3 12 3 14 3 12 9 13 4 3 5 12 9 4 3 5 5 6 10 9 12 3 5 6 10 10 2 11 12 3 5 12 10 9 5 12 10 9 12 9 6 3 12 2 3 6 9 7 12 10 10 9 12 9 6 2 3 6 3 6 10 9 5 4 9 5 5 13 5 6 2 10 11 6 10 10 9 5 6 3 14 10 8 3 5 13 
14 3 5 5 12 9 6 10 10 3 5 5 14 10 2 9 6 11 5 6 9 13 5 5 6 9 6 8 9 5 5 12 10 9 7 5 6 3 5 12 3 7 12 9 5 12 10 9 7 5 5 5 12 3 7 5 6 9 5 6 10 9 5 5 12 3 12 10 10 10 9 6 10 1 7 12 2 3 7 12 1 5 5 12 9 5 14 10 9 6 9 5 14 10 3 5 6 10 10 10 9 12 8 11 5 5 7 5 5 5 5 4 10 10 10 10 9 12 10 3 5 12 10 8 9 4 9 6 1 
12 10 3 5 5 5 12 9 12 10 3 6 10 9 13 6 10 9 6 9 6 1 5 6 9 6 9 7 5 5 4 2 11 6 10 2 10 9 5 5 12 10 3 5 6 3 13 6 8 3 5 5 6 10 9 6 9 6 3 13 12 1 5 7 4 10 3 12 10 9 6 10 9 5 12 3 14 10 10 3 5 7 5 7 6 2 10 9 6 10 1 6 10 9 12 2 11 12 10 9 6 3 6 10 3 7 12 3 5 5 5 6 10 10 8 9 5 5 12 10 3 6 11 5 5 7 6 9 5 
7 12 9 5 5 6 3 4 3 12 10 10 9 5 5 12 10 2 9 6 10 3 6 9 6 10 1 12 3 5 6 10 9 14 9 13 12 3 7 6 2 10 11 6 8 9 6 9 6 10 3 7 12 10 3 12 3 14 9 6 1 7 4 9 6 10 9 5 12 3 13 12 3 5 6 10 10 10 10 9 6 9 6 10 10 8 8 3 13 12 3 13 12 2 3 14 9 6 9 6 9 12 10 10 11 12 1 12 1 5 5 12 10 9 5 5 4 2 3 12 10 10 9 5 4 8 9 5 5 
12 3 6 3 6 8 9 5 12 3 12 9 5 6 1 7 12 10 2 10 10 8 9 6 10 8 3 5 12 1 12 9 6 9 5 5 4 10 10 10 10 9 12 11 5 6 10 3 12 11 12 10 3 12 10 2 10 9 5 12 3 12 3 6 8 9 6 3 4 9 5 4 9 6 10 9 13 12 9 5 13 6 10 10 10 3 5 12 1 6 10 1 5 12 10 10 1 13 6 9 6 3 12 10 8 3 5 5 5 6 3 5 12 3 5 5 7 12 9 5 12 11 5 5 7 5 4 1 5 
4 8 10 10 9 7 5 7 4 10 3 7 4 9 7 12 3 12 10 10 8 3 6 10 9 6 10 3 5 6 3 5 12 3 5 5 6 10 10 9 13 5 6 10 2 11 12 9 4 9 4 10 10 3 14 9 13 6 1 6 9 6 11 12 3 6 10 9 7 6 3 5 4 10 11 5 4 3 6 2 3 13 12 9 12 8 3 7 5 13 12 3 5 6 9 13 6 2 9 6 10 8 3 13 5 12 3 5 6 10 9 7 5 13 5 5 12 3 6 2 3 12 3 6 9 7 5 5 5 
5 6 10 11 6 9 6 9 5 12 10 9 7 5 12 3 12 3 12 9 6 10 10 9 6 10 8 10 2 9 12 3 6 10 3 6 9 14 9 6 3 4 10 10 10 10 3 4 3 6 2 10 10 10 9 5 6 9 6 9 5 12 8 3 14 10 9 6 10 10 11 5 6 9 12 3 5 12 10 10 10 2 3 6 1 7 12 9 6 1 6 9 5 13 6 3 12 9 5 14 9 5 12 3 5 5 13 4 9 13 4 8 3 6 3 5 6 9 12 9 12 3 12 9 6 9 5 5 5 
5 12 8 10 10 3 13 4 3 5 12 3 12 3 5 12 1 12 3 6 10 10 11 6 10 9 4 10 9 7 6 10 10 10 10 9 6 9 5 12 11 6 10 9 12 10 9 6 9 14 9 12 10 11 5 5 12 2 11 5 5 5 6 10 9 12 3 13 12 10 10 3 12 3 7 12 3 6 10 10 9 14 10 9 6 10 3 6 9 6 9 5 5 6 9 12 3 6 2 10 3 5 6 9 5 6 3 5 6 3 5 7 12 9 12 2 9 6 1 7 6 10 3 7 12 3 7 5 5 
5 5 5 12 10 9 5 5 12 3 5 12 3 12 3 5 7 5 13 12 8 10 8 10 10 3 6 11 6 9 12 9 12 9 13 6 10 2 3 6 10 9 12 3 4 11 4 9 6 10 3 6 10 10 3 5 5 14 9 5 5 6 9 12 3 5 12 3 6 9 12 10 3 12 10 2 10 10 10 9 5 12 9 5 12 10 11 12 1 12 2 3 6 10 1 5 12 10 10 9 12 3 14 2 3 14 10 3 12 9 4 10 3 5 4 9 6 9 5 12 9 13 12 8 3 12 9 5 5 
5 5 7 5 13 6 3 6 3 13 5 6 9 4 9 6 9 5 6 3 7 12 1 12 9 14 9 12 10 3 7 5 5 6 3 12 10 8 10 10 11 5 4 10 2 9 7 6 9 12 9 12 9 12 10 3 6 9 6 3 6 11 5 4 10 1 5 12 9 5 4 10 10 3 12 10 10 9 13 4 2 3 6 3 5 14 8 3 5 5 12 9 13 12 2 3 5 13 12 3 6 10 10 10 10 10 8 11 5 5 6 11 12 3 7 6 9 5 5 5 6 3 5 6 9 7 5 5 5 
5 6 9 6 2 9 14 9 12 3 5 12 3 7 6 9 6 3 12 9 12 3 5 5 5 12 3 5 12 10 9 5 6 10 9 5 12 3 12 9 12 3 6 10 9 7 12 10 3 7 5 5 5 6 10 10 9 5 12 8 10 8 1 6 9 5 5 5 6 3 6 10 10 9 6 9 12 3 5 6 9 12 10 10 3 12 3 14 3 5 7 6 1 5 12 9 5 6 3 12 10 10 9 12 10 11 5 12 3 5 12 10 3 12 10 9 5 5 5 5 14 9 4 9 6 10 3 7 5 
5 13 4 10 9 6 9 5 5 12 1 6 8 9 13 4 10 10 3 5 5 12 3 5 6 3 12 2 3 12 3 6 10 9 5 5 5 14 3 4 1 12 9 13 6 9 6 10 10 8 2 3 6 10 10 10 2 3 5 5 13 5 5 12 3 5 5 5 14 9 12 9 12 2 9 5 6 10 1 14 3 5 12 10 9 6 10 10 9 6 9 12 3 5 5 5 5 13 12 3 13 12 3 5 14 8 3 7 12 3 6 10 10 1 12 3 5 4 3 6 9 5 5 5 12 9 12 9 5 
5 5 6 9 6 9 6 1 5 5 4 9 7 6 3 6 10 9 12 3 5 6 10 2 10 9 6 10 9 6 10 10 10 3 6 3 6 10 10 3 5 7 6 1 13 6 9 12 9 6 11 12 10 9 12 10 9 12 3 5 5 5 5 4 9 7 5 4 10 2 3 7 6 9 5 6 9 12 2 10 10 1 7 12 3 14 10 9 4 10 3 6 9 5 7 5 4 3 6 9 5 5 13 5 12 3 14 9 6 10 10 10 9 5 5 12 3 7 12 10 3 5 5 5 5 6 3 6 1 
6 2 11 6 9 6 10 2 3 5 5 4 9 12 10 10 11 5 5 13 4 8 10 10 9 6 10 11 5 12 10 9 12 10 10 9 12 9 12 9 6 10 9 6 1 13 4 3 4 11 12 3 13 5 5 14 3 5 12 3 6 3 5 5 6 9 5 6 10 9 12 10 10 3 6 9 5 5 14 9 13 4 9 5 12 10 10 3 6 10 8 9 5 5 12 3 5 12 9 5 6 3 6 1 6 10 10 2 10 11 12 9 5 5 5 6 10 9 5 12 11 6 3 5 6 10 10 9 5 
12 10 10 9 5 12 10 9 12 3 5 7 6 3 12 8 10 3 5 6 3 7 12 9 5 12 10 10 3 5 13 5 6 9 13 4 3 4 3 6 10 10 2 10 2 3 6 9 6 9 6 10 3 5 6 10 9 5 5 14 9 13 5 6 9 6 3 12 10 3 6 8 9 12 9 7 5 6 9 5 5 5 6 3 5 13 12 10 10 9 7 5 5 5 5 12 3 5 6 3 12 10 8 1 13 12 10 10 10 10 3 5 5 7 5 13 12 3 5 5 12 10 10 2 10 8 9 5 7 
5 12 10 3 4 3 13 5 6 9 6 9 12 10 3 6 10 11 5 12 8 10 3 6 3 6 10 9 12 3 5 6 9 4 3 6 9 7 12 9 14 8 11 12 10 8 9 6 9 6 8 11 12 3 14 9 6 3 6 10 2 3 5 13 6 10 9 6 8 10 9 7 4 3 6 9 6 11 5 5 5 7 12 10 3 6 3 12 9 6 9 5 5 5 5 5 13 5 12 9 5 12 3 6 1 6 9 12 10 10 9 6 3 12 3 5 5 12 3 6 3 13 12 8 9 7 5 4 9 
7 5 12 9 5 13 5 6 9 6 9 7 6 8 10 9 12 8 3 7 5 12 10 10 9 12 9 5 5 13 6 9 6 3 12 9 5 12 3 6 10 2 10 3 12 3 6 9 6 11 6 9 6 10 9 6 10 9 12 10 11 12 3 5 12 11 6 9 6 11 6 9 7 12 9 5 12 9 5 5 5 12 3 12 8 11 12 3 6 10 3 4 3 5 5 5 4 1 5 6 3 6 10 9 5 13 6 3 12 9 5 12 10 1 12 3 4 3 12 10 9 6 3 5 4 10 3 5 5 
12 2 3 5 6 3 5 12 1 12 3 12 9 7 12 3 5 4 9 12 3 5 12 11 5 5 5 6 2 3 13 6 10 10 3 5 6 3 12 10 10 9 12 9 5 12 9 7 12 10 9 6 10 9 6 10 9 5 6 10 10 3 12 3 6 10 9 5 12 9 13 4 9 5 5 6 3 6 3 6 1 6 10 3 4 10 3 12 11 12 10 3 12 3 5 5 5 5 6 10 10 11 12 3 6 2 10 9 5 6 3 6 11 5 5 13 6 9 6 9 7 12 10 1 5 12 10 3 5 
5 12 9 7 12 9 4 3 7 6 9 5 5 12 3 12 3 5 5 5 12 3 6 9 4 3 6 10 8 10 3 12 10 10 9 5 12 9 6 9 14 3 5 5 6 3 5 12 2 11 6 10 9 6 10 9 6 2 10 10 10 9 6 10 9 12 3 5 5 6 3 7 5 5 6 10 10 10 10 9 4 11 12 10 2 9 13 6 9 6 10 8 2 10 3 5 5 6 10 10 10 10 3 12 9 12 9 5 5 14 10 8 10 3 5 6 9 6 11 5 12 3 12 3 7 6 9 12 3 
5 5 6 10 1 5 5 12 10 10 3 5 6 3 13 5 14 3 5 6 2 10 9 5 6 10 10 9 6 10 9 5 14 9 6 3 5 4 9 6 10 9 5 6 9 12 3 6 9 12 10 9 5 12 10 2 11 12 10 10 9 6 9 12 1 5 12 3 5 12 10 9 6 2 10 10 10 8 9 6 2 10 1 12 9 7 4 9 5 12 9 5 12 9 12 1 6 9 14 10 8 9 12 3 5 5 6 3 6 10 9 6 10 10 3 12 2 10 8 1 6 11 5 14 9 12 3 6 9 
5 5 14 9 7 5 5 6 10 9 12 3 12 10 3 6 9 12 3 13 12 9 6 3 12 10 9 6 10 9 5 6 10 1 12 10 3 5 6 11 12 3 4 11 5 6 10 8 3 6 9 5 5 6 10 10 9 4 10 11 4 11 5 5 5 5 6 10 3 5 12 3 14 9 12 10 9 7 4 8 10 9 7 5 6 10 3 6 1 7 5 7 5 5 5 5 14 3 12 9 5 7 6 9 5 6 9 12 10 10 2 10 10 10 10 3 12 9 5 6 8 10 3 12 1 5 13 12 3 
5 6 9 6 10 3 5 12 10 3 6 10 3 13 12 8 3 6 9 6 3 6 10 8 3 14 3 12 9 5 6 10 9 5 5 12 11 6 10 10 3 12 3 12 3 12 9 5 12 9 5 5 6 10 10 9 6 3 12 9 6 9 6 3 6 1 12 10 10 3 4 10 10 3 6 9 6 9 7 4 9 6 9 6 10 11 12 9 5 12 3 12 3 7 5 6 10 10 3 5 6 10 10 3 5 12 1 7 12 10 10 10 10 10 10 9 5 6 3 14 3 12 8 3 5 6 3 4 9 
6 9 6 10 10 10 3 5 12 10 8 10 10 1 7 6 10 9 4 10 10 10 9 5 12 10 10 3 5 4 10 9 6 3 6 1 12 10 10 10 10 3 13 5 12 3 5 6 3 6 3 6 10 9 12 3 12 10 3 6 9 4 11 12 10 3 5 14 10 9 6 9 12 10 10 3 14 3 12 3 6 11 5 12 10 10 3 6 3 6 9 6 10 10 3 12 10 10 9 6 10 10 8 9 6 3 6 9 6 10 11 12 9 12 9 6 3 14 10 10 10 3 5 12 3 14 10 3 5 
14 2 10 10 10 10 10 3 6 11 6 10 11 6 10 10 10 3 6 10 10 11 6 2 3 14 10 10 3 6 11 6 10 10 10 2 2 10 10 10 10 10 3 6 3 14 3 14 10 10 10 10 10 3 6 10 3 14 10 10 3 6 10 2 10 10 2 10 10 3 14 3 6 10 10 10 10 10 3 14 10 10 3 6 10 10 10 10 10 10 2 10 10 10 10 3 14 10 2 10 10 10 3 6 10 10 10 2 10 10 10 3 6 3 6 10 10 10 10 10 10 10 3 6 10 10 10 10 3 
